XXXXXXXn
XXXdXXXn
XX  XXXn
XX   XXn
XXX  XXn
XX d XXn
XX X XXn
XXXXXXXn